11111111111
1010000E001
10100000001
10100100001
10100000001
10100C00001
1010000C001
10100000001
10100010001
1000P000001
11111111111