
11111111111
101P0000001
10100000001
10100100001
10100000001
101000C0001
1010E000001
10100000001
10100010001
10000000001
11111111111